/media/remote_home/weiling/project/Action_Category_CVG/training/gt/pose3d/S11_directions_1.npy	/media/remote_home/weiling/project/Action_Category_CVG/training/gt/label/S11_directions_1.csv
/media/remote_home/weiling/project/Action_Category_CVG/training/gt/pose3d/S11_directions_2.npy	/media/remote_home/weiling/project/Action_Category_CVG/training/gt/label/S11_directions_2.csv
/media/remote_home/weiling/project/Action_Category_CVG/training/gt/pose3d/S11_discussion_1.npy	/media/remote_home/weiling/project/Action_Category_CVG/training/gt/label/S11_discussion_1.csv
/media/remote_home/weiling/project/Action_Category_CVG/training/gt/pose3d/S11_discussion_2.npy	/media/remote_home/weiling/project/Action_Category_CVG/training/gt/label/S11_discussion_2.csv
/media/remote_home/weiling/project/Action_Category_CVG/training/gt/pose3d/S11_eating_1.npy	/media/remote_home/weiling/project/Action_Category_CVG/training/gt/label/S11_eating_1.csv
/media/remote_home/weiling/project/Action_Category_CVG/training/gt/pose3d/S11_eating_2.npy	/media/remote_home/weiling/project/Action_Category_CVG/training/gt/label/S11_eating_2.csv
/media/remote_home/weiling/project/Action_Category_CVG/training/gt/pose3d/S11_greeting_1.npy	/media/remote_home/weiling/project/Action_Category_CVG/training/gt/label/S11_greeting_1.csv
/media/remote_home/weiling/project/Action_Category_CVG/training/gt/pose3d/S11_greeting_2.npy	/media/remote_home/weiling/project/Action_Category_CVG/training/gt/label/S11_greeting_2.csv
/media/remote_home/weiling/project/Action_Category_CVG/training/gt/pose3d/S11_phoning_1.npy	/media/remote_home/weiling/project/Action_Category_CVG/training/gt/label/S11_phoning_1.csv
/media/remote_home/weiling/project/Action_Category_CVG/training/gt/pose3d/S11_phoning_2.npy	/media/remote_home/weiling/project/Action_Category_CVG/training/gt/label/S11_phoning_2.csv
/media/remote_home/weiling/project/Action_Category_CVG/training/gt/pose3d/S11_photo_1.npy	/media/remote_home/weiling/project/Action_Category_CVG/training/gt/label/S11_photo_1.csv
/media/remote_home/weiling/project/Action_Category_CVG/training/gt/pose3d/S11_photo_2.npy	/media/remote_home/weiling/project/Action_Category_CVG/training/gt/label/S11_photo_2.csv
/media/remote_home/weiling/project/Action_Category_CVG/training/gt/pose3d/S11_posing_1.npy	/media/remote_home/weiling/project/Action_Category_CVG/training/gt/label/S11_posing_1.csv
/media/remote_home/weiling/project/Action_Category_CVG/training/gt/pose3d/S11_posing_2.npy	/media/remote_home/weiling/project/Action_Category_CVG/training/gt/label/S11_posing_2.csv
/media/remote_home/weiling/project/Action_Category_CVG/training/gt/pose3d/S11_purchases_1.npy	/media/remote_home/weiling/project/Action_Category_CVG/training/gt/label/S11_purchases_1.csv
/media/remote_home/weiling/project/Action_Category_CVG/training/gt/pose3d/S11_purchases_2.npy	/media/remote_home/weiling/project/Action_Category_CVG/training/gt/label/S11_purchases_2.csv
/media/remote_home/weiling/project/Action_Category_CVG/training/gt/pose3d/S11_sitting_1.npy	/media/remote_home/weiling/project/Action_Category_CVG/training/gt/label/S11_sitting_1.csv
/media/remote_home/weiling/project/Action_Category_CVG/training/gt/pose3d/S11_sitting_2.npy	/media/remote_home/weiling/project/Action_Category_CVG/training/gt/label/S11_sitting_2.csv
/media/remote_home/weiling/project/Action_Category_CVG/training/gt/pose3d/S11_sittingdown_1.npy	/media/remote_home/weiling/project/Action_Category_CVG/training/gt/label/S11_sittingdown_1.csv
/media/remote_home/weiling/project/Action_Category_CVG/training/gt/pose3d/S11_sittingdown_2.npy	/media/remote_home/weiling/project/Action_Category_CVG/training/gt/label/S11_sittingdown_2.csv
/media/remote_home/weiling/project/Action_Category_CVG/training/gt/pose3d/S11_smoking_1.npy	/media/remote_home/weiling/project/Action_Category_CVG/training/gt/label/S11_smoking_1.csv
/media/remote_home/weiling/project/Action_Category_CVG/training/gt/pose3d/S11_smoking_2.npy	/media/remote_home/weiling/project/Action_Category_CVG/training/gt/label/S11_smoking_2.csv
/media/remote_home/weiling/project/Action_Category_CVG/training/gt/pose3d/S11_waiting_1.npy	/media/remote_home/weiling/project/Action_Category_CVG/training/gt/label/S11_waiting_1.csv
/media/remote_home/weiling/project/Action_Category_CVG/training/gt/pose3d/S11_waiting_2.npy	/media/remote_home/weiling/project/Action_Category_CVG/training/gt/label/S11_waiting_2.csv
/media/remote_home/weiling/project/Action_Category_CVG/training/gt/pose3d/S11_walkdog_1.npy	/media/remote_home/weiling/project/Action_Category_CVG/training/gt/label/S11_walkdog_1.csv
/media/remote_home/weiling/project/Action_Category_CVG/training/gt/pose3d/S11_walkdog_2.npy	/media/remote_home/weiling/project/Action_Category_CVG/training/gt/label/S11_walkdog_2.csv
/media/remote_home/weiling/project/Action_Category_CVG/training/gt/pose3d/S11_walking_1.npy	/media/remote_home/weiling/project/Action_Category_CVG/training/gt/label/S11_walking_1.csv
/media/remote_home/weiling/project/Action_Category_CVG/training/gt/pose3d/S11_walking_2.npy	/media/remote_home/weiling/project/Action_Category_CVG/training/gt/label/S11_walking_2.csv
/media/remote_home/weiling/project/Action_Category_CVG/training/gt/pose3d/S11_walkingtogether_1.npy	/media/remote_home/weiling/project/Action_Category_CVG/training/gt/label/S11_walkingtogether_1.csv
/media/remote_home/weiling/project/Action_Category_CVG/training/gt/pose3d/S11_walkingtogether_2.npy	/media/remote_home/weiling/project/Action_Category_CVG/training/gt/label/S11_walkingtogether_2.csv
/media/remote_home/weiling/project/Action_Category_CVG/training/gt/pose3d/S1_directions_1.npy	/media/remote_home/weiling/project/Action_Category_CVG/training/gt/label/S1_directions_1.csv
/media/remote_home/weiling/project/Action_Category_CVG/training/gt/pose3d/S1_directions_2.npy	/media/remote_home/weiling/project/Action_Category_CVG/training/gt/label/S1_directions_2.csv
/media/remote_home/weiling/project/Action_Category_CVG/training/gt/pose3d/S1_discussion_1.npy	/media/remote_home/weiling/project/Action_Category_CVG/training/gt/label/S1_discussion_1.csv
/media/remote_home/weiling/project/Action_Category_CVG/training/gt/pose3d/S1_discussion_2.npy	/media/remote_home/weiling/project/Action_Category_CVG/training/gt/label/S1_discussion_2.csv
/media/remote_home/weiling/project/Action_Category_CVG/training/gt/pose3d/S1_eating_1.npy	/media/remote_home/weiling/project/Action_Category_CVG/training/gt/label/S1_eating_1.csv
/media/remote_home/weiling/project/Action_Category_CVG/training/gt/pose3d/S1_eating_2.npy	/media/remote_home/weiling/project/Action_Category_CVG/training/gt/label/S1_eating_2.csv
/media/remote_home/weiling/project/Action_Category_CVG/training/gt/pose3d/S1_greeting_1.npy	/media/remote_home/weiling/project/Action_Category_CVG/training/gt/label/S1_greeting_1.csv
/media/remote_home/weiling/project/Action_Category_CVG/training/gt/pose3d/S1_greeting_2.npy	/media/remote_home/weiling/project/Action_Category_CVG/training/gt/label/S1_greeting_2.csv
/media/remote_home/weiling/project/Action_Category_CVG/training/gt/pose3d/S1_phoning_1.npy	/media/remote_home/weiling/project/Action_Category_CVG/training/gt/label/S1_phoning_1.csv
/media/remote_home/weiling/project/Action_Category_CVG/training/gt/pose3d/S1_phoning_2.npy	/media/remote_home/weiling/project/Action_Category_CVG/training/gt/label/S1_phoning_2.csv
/media/remote_home/weiling/project/Action_Category_CVG/training/gt/pose3d/S1_photo_1.npy	/media/remote_home/weiling/project/Action_Category_CVG/training/gt/label/S1_photo_1.csv
/media/remote_home/weiling/project/Action_Category_CVG/training/gt/pose3d/S1_photo_2.npy	/media/remote_home/weiling/project/Action_Category_CVG/training/gt/label/S1_photo_2.csv
/media/remote_home/weiling/project/Action_Category_CVG/training/gt/pose3d/S1_posing_1.npy	/media/remote_home/weiling/project/Action_Category_CVG/training/gt/label/S1_posing_1.csv
/media/remote_home/weiling/project/Action_Category_CVG/training/gt/pose3d/S1_posing_2.npy	/media/remote_home/weiling/project/Action_Category_CVG/training/gt/label/S1_posing_2.csv
/media/remote_home/weiling/project/Action_Category_CVG/training/gt/pose3d/S1_purchases_1.npy	/media/remote_home/weiling/project/Action_Category_CVG/training/gt/label/S1_purchases_1.csv
/media/remote_home/weiling/project/Action_Category_CVG/training/gt/pose3d/S1_purchases_2.npy	/media/remote_home/weiling/project/Action_Category_CVG/training/gt/label/S1_purchases_2.csv
/media/remote_home/weiling/project/Action_Category_CVG/training/gt/pose3d/S1_sitting_1.npy	/media/remote_home/weiling/project/Action_Category_CVG/training/gt/label/S1_sitting_1.csv
/media/remote_home/weiling/project/Action_Category_CVG/training/gt/pose3d/S1_sitting_2.npy	/media/remote_home/weiling/project/Action_Category_CVG/training/gt/label/S1_sitting_2.csv
/media/remote_home/weiling/project/Action_Category_CVG/training/gt/pose3d/S1_sittingdown_1.npy	/media/remote_home/weiling/project/Action_Category_CVG/training/gt/label/S1_sittingdown_1.csv
/media/remote_home/weiling/project/Action_Category_CVG/training/gt/pose3d/S1_sittingdown_2.npy	/media/remote_home/weiling/project/Action_Category_CVG/training/gt/label/S1_sittingdown_2.csv
/media/remote_home/weiling/project/Action_Category_CVG/training/gt/pose3d/S1_smoking_1.npy	/media/remote_home/weiling/project/Action_Category_CVG/training/gt/label/S1_smoking_1.csv
/media/remote_home/weiling/project/Action_Category_CVG/training/gt/pose3d/S1_smoking_2.npy	/media/remote_home/weiling/project/Action_Category_CVG/training/gt/label/S1_smoking_2.csv
/media/remote_home/weiling/project/Action_Category_CVG/training/gt/pose3d/S1_waiting_1.npy	/media/remote_home/weiling/project/Action_Category_CVG/training/gt/label/S1_waiting_1.csv
/media/remote_home/weiling/project/Action_Category_CVG/training/gt/pose3d/S1_waiting_2.npy	/media/remote_home/weiling/project/Action_Category_CVG/training/gt/label/S1_waiting_2.csv
/media/remote_home/weiling/project/Action_Category_CVG/training/gt/pose3d/S1_walkdog_1.npy	/media/remote_home/weiling/project/Action_Category_CVG/training/gt/label/S1_walkdog_1.csv
/media/remote_home/weiling/project/Action_Category_CVG/training/gt/pose3d/S1_walkdog_2.npy	/media/remote_home/weiling/project/Action_Category_CVG/training/gt/label/S1_walkdog_2.csv
/media/remote_home/weiling/project/Action_Category_CVG/training/gt/pose3d/S1_walking_1.npy	/media/remote_home/weiling/project/Action_Category_CVG/training/gt/label/S1_walking_1.csv
/media/remote_home/weiling/project/Action_Category_CVG/training/gt/pose3d/S1_walking_2.npy	/media/remote_home/weiling/project/Action_Category_CVG/training/gt/label/S1_walking_2.csv
/media/remote_home/weiling/project/Action_Category_CVG/training/gt/pose3d/S1_walkingtogether_1.npy	/media/remote_home/weiling/project/Action_Category_CVG/training/gt/label/S1_walkingtogether_1.csv
/media/remote_home/weiling/project/Action_Category_CVG/training/gt/pose3d/S1_walkingtogether_2.npy	/media/remote_home/weiling/project/Action_Category_CVG/training/gt/label/S1_walkingtogether_2.csv
/media/remote_home/weiling/project/Action_Category_CVG/training/gt/pose3d/S5_directions_1.npy	/media/remote_home/weiling/project/Action_Category_CVG/training/gt/label/S5_directions_1.csv
/media/remote_home/weiling/project/Action_Category_CVG/training/gt/pose3d/S5_directions_2.npy	/media/remote_home/weiling/project/Action_Category_CVG/training/gt/label/S5_directions_2.csv
/media/remote_home/weiling/project/Action_Category_CVG/training/gt/pose3d/S5_discussion_1.npy	/media/remote_home/weiling/project/Action_Category_CVG/training/gt/label/S5_discussion_1.csv
/media/remote_home/weiling/project/Action_Category_CVG/training/gt/pose3d/S5_discussion_2.npy	/media/remote_home/weiling/project/Action_Category_CVG/training/gt/label/S5_discussion_2.csv
/media/remote_home/weiling/project/Action_Category_CVG/training/gt/pose3d/S5_eating_1.npy	/media/remote_home/weiling/project/Action_Category_CVG/training/gt/label/S5_eating_1.csv
/media/remote_home/weiling/project/Action_Category_CVG/training/gt/pose3d/S5_eating_2.npy	/media/remote_home/weiling/project/Action_Category_CVG/training/gt/label/S5_eating_2.csv
/media/remote_home/weiling/project/Action_Category_CVG/training/gt/pose3d/S5_greeting_1.npy	/media/remote_home/weiling/project/Action_Category_CVG/training/gt/label/S5_greeting_1.csv
/media/remote_home/weiling/project/Action_Category_CVG/training/gt/pose3d/S5_greeting_2.npy	/media/remote_home/weiling/project/Action_Category_CVG/training/gt/label/S5_greeting_2.csv
/media/remote_home/weiling/project/Action_Category_CVG/training/gt/pose3d/S5_phoning_1.npy	/media/remote_home/weiling/project/Action_Category_CVG/training/gt/label/S5_phoning_1.csv
/media/remote_home/weiling/project/Action_Category_CVG/training/gt/pose3d/S5_phoning_2.npy	/media/remote_home/weiling/project/Action_Category_CVG/training/gt/label/S5_phoning_2.csv
/media/remote_home/weiling/project/Action_Category_CVG/training/gt/pose3d/S5_photo_1.npy	/media/remote_home/weiling/project/Action_Category_CVG/training/gt/label/S5_photo_1.csv
/media/remote_home/weiling/project/Action_Category_CVG/training/gt/pose3d/S5_photo_2.npy	/media/remote_home/weiling/project/Action_Category_CVG/training/gt/label/S5_photo_2.csv
/media/remote_home/weiling/project/Action_Category_CVG/training/gt/pose3d/S5_posing_1.npy	/media/remote_home/weiling/project/Action_Category_CVG/training/gt/label/S5_posing_1.csv
/media/remote_home/weiling/project/Action_Category_CVG/training/gt/pose3d/S5_posing_2.npy	/media/remote_home/weiling/project/Action_Category_CVG/training/gt/label/S5_posing_2.csv
/media/remote_home/weiling/project/Action_Category_CVG/training/gt/pose3d/S5_purchases_1.npy	/media/remote_home/weiling/project/Action_Category_CVG/training/gt/label/S5_purchases_1.csv
/media/remote_home/weiling/project/Action_Category_CVG/training/gt/pose3d/S5_purchases_2.npy	/media/remote_home/weiling/project/Action_Category_CVG/training/gt/label/S5_purchases_2.csv
/media/remote_home/weiling/project/Action_Category_CVG/training/gt/pose3d/S5_sitting_1.npy	/media/remote_home/weiling/project/Action_Category_CVG/training/gt/label/S5_sitting_1.csv
/media/remote_home/weiling/project/Action_Category_CVG/training/gt/pose3d/S5_sitting_2.npy	/media/remote_home/weiling/project/Action_Category_CVG/training/gt/label/S5_sitting_2.csv
/media/remote_home/weiling/project/Action_Category_CVG/training/gt/pose3d/S5_sittingdown_1.npy	/media/remote_home/weiling/project/Action_Category_CVG/training/gt/label/S5_sittingdown_1.csv
/media/remote_home/weiling/project/Action_Category_CVG/training/gt/pose3d/S5_sittingdown_2.npy	/media/remote_home/weiling/project/Action_Category_CVG/training/gt/label/S5_sittingdown_2.csv
/media/remote_home/weiling/project/Action_Category_CVG/training/gt/pose3d/S5_smoking_1.npy	/media/remote_home/weiling/project/Action_Category_CVG/training/gt/label/S5_smoking_1.csv
/media/remote_home/weiling/project/Action_Category_CVG/training/gt/pose3d/S5_smoking_2.npy	/media/remote_home/weiling/project/Action_Category_CVG/training/gt/label/S5_smoking_2.csv
/media/remote_home/weiling/project/Action_Category_CVG/training/gt/pose3d/S5_waiting_1.npy	/media/remote_home/weiling/project/Action_Category_CVG/training/gt/label/S5_waiting_1.csv
/media/remote_home/weiling/project/Action_Category_CVG/training/gt/pose3d/S5_waiting_2.npy	/media/remote_home/weiling/project/Action_Category_CVG/training/gt/label/S5_waiting_2.csv
/media/remote_home/weiling/project/Action_Category_CVG/training/gt/pose3d/S5_walkdog_1.npy	/media/remote_home/weiling/project/Action_Category_CVG/training/gt/label/S5_walkdog_1.csv
/media/remote_home/weiling/project/Action_Category_CVG/training/gt/pose3d/S5_walkdog_2.npy	/media/remote_home/weiling/project/Action_Category_CVG/training/gt/label/S5_walkdog_2.csv
/media/remote_home/weiling/project/Action_Category_CVG/training/gt/pose3d/S5_walking_1.npy	/media/remote_home/weiling/project/Action_Category_CVG/training/gt/label/S5_walking_1.csv
/media/remote_home/weiling/project/Action_Category_CVG/training/gt/pose3d/S5_walking_2.npy	/media/remote_home/weiling/project/Action_Category_CVG/training/gt/label/S5_walking_2.csv
/media/remote_home/weiling/project/Action_Category_CVG/training/gt/pose3d/S5_walkingtogether_1.npy	/media/remote_home/weiling/project/Action_Category_CVG/training/gt/label/S5_walkingtogether_1.csv
/media/remote_home/weiling/project/Action_Category_CVG/training/gt/pose3d/S5_walkingtogether_2.npy	/media/remote_home/weiling/project/Action_Category_CVG/training/gt/label/S5_walkingtogether_2.csv
/media/remote_home/weiling/project/Action_Category_CVG/training/gt/pose3d/S6_directions_1.npy	/media/remote_home/weiling/project/Action_Category_CVG/training/gt/label/S6_directions_1.csv
/media/remote_home/weiling/project/Action_Category_CVG/training/gt/pose3d/S6_directions_2.npy	/media/remote_home/weiling/project/Action_Category_CVG/training/gt/label/S6_directions_2.csv
/media/remote_home/weiling/project/Action_Category_CVG/training/gt/pose3d/S6_discussion_1.npy	/media/remote_home/weiling/project/Action_Category_CVG/training/gt/label/S6_discussion_1.csv
/media/remote_home/weiling/project/Action_Category_CVG/training/gt/pose3d/S6_discussion_2.npy	/media/remote_home/weiling/project/Action_Category_CVG/training/gt/label/S6_discussion_2.csv
/media/remote_home/weiling/project/Action_Category_CVG/training/gt/pose3d/S6_eating_1.npy	/media/remote_home/weiling/project/Action_Category_CVG/training/gt/label/S6_eating_1.csv
/media/remote_home/weiling/project/Action_Category_CVG/training/gt/pose3d/S6_eating_2.npy	/media/remote_home/weiling/project/Action_Category_CVG/training/gt/label/S6_eating_2.csv
/media/remote_home/weiling/project/Action_Category_CVG/training/gt/pose3d/S6_greeting_1.npy	/media/remote_home/weiling/project/Action_Category_CVG/training/gt/label/S6_greeting_1.csv
/media/remote_home/weiling/project/Action_Category_CVG/training/gt/pose3d/S6_greeting_2.npy	/media/remote_home/weiling/project/Action_Category_CVG/training/gt/label/S6_greeting_2.csv
/media/remote_home/weiling/project/Action_Category_CVG/training/gt/pose3d/S6_phoning_1.npy	/media/remote_home/weiling/project/Action_Category_CVG/training/gt/label/S6_phoning_1.csv
/media/remote_home/weiling/project/Action_Category_CVG/training/gt/pose3d/S6_phoning_2.npy	/media/remote_home/weiling/project/Action_Category_CVG/training/gt/label/S6_phoning_2.csv
/media/remote_home/weiling/project/Action_Category_CVG/training/gt/pose3d/S6_photo_1.npy	/media/remote_home/weiling/project/Action_Category_CVG/training/gt/label/S6_photo_1.csv
/media/remote_home/weiling/project/Action_Category_CVG/training/gt/pose3d/S6_photo_2.npy	/media/remote_home/weiling/project/Action_Category_CVG/training/gt/label/S6_photo_2.csv
/media/remote_home/weiling/project/Action_Category_CVG/training/gt/pose3d/S6_posing_1.npy	/media/remote_home/weiling/project/Action_Category_CVG/training/gt/label/S6_posing_1.csv
/media/remote_home/weiling/project/Action_Category_CVG/training/gt/pose3d/S6_posing_2.npy	/media/remote_home/weiling/project/Action_Category_CVG/training/gt/label/S6_posing_2.csv
/media/remote_home/weiling/project/Action_Category_CVG/training/gt/pose3d/S6_purchases_1.npy	/media/remote_home/weiling/project/Action_Category_CVG/training/gt/label/S6_purchases_1.csv
/media/remote_home/weiling/project/Action_Category_CVG/training/gt/pose3d/S6_purchases_2.npy	/media/remote_home/weiling/project/Action_Category_CVG/training/gt/label/S6_purchases_2.csv
/media/remote_home/weiling/project/Action_Category_CVG/training/gt/pose3d/S6_sitting_1.npy	/media/remote_home/weiling/project/Action_Category_CVG/training/gt/label/S6_sitting_1.csv
/media/remote_home/weiling/project/Action_Category_CVG/training/gt/pose3d/S6_sitting_2.npy	/media/remote_home/weiling/project/Action_Category_CVG/training/gt/label/S6_sitting_2.csv
/media/remote_home/weiling/project/Action_Category_CVG/training/gt/pose3d/S6_sittingdown_1.npy	/media/remote_home/weiling/project/Action_Category_CVG/training/gt/label/S6_sittingdown_1.csv
/media/remote_home/weiling/project/Action_Category_CVG/training/gt/pose3d/S6_sittingdown_2.npy	/media/remote_home/weiling/project/Action_Category_CVG/training/gt/label/S6_sittingdown_2.csv
/media/remote_home/weiling/project/Action_Category_CVG/training/gt/pose3d/S6_smoking_1.npy	/media/remote_home/weiling/project/Action_Category_CVG/training/gt/label/S6_smoking_1.csv
/media/remote_home/weiling/project/Action_Category_CVG/training/gt/pose3d/S6_smoking_2.npy	/media/remote_home/weiling/project/Action_Category_CVG/training/gt/label/S6_smoking_2.csv
/media/remote_home/weiling/project/Action_Category_CVG/training/gt/pose3d/S6_waiting_1.npy	/media/remote_home/weiling/project/Action_Category_CVG/training/gt/label/S6_waiting_1.csv
/media/remote_home/weiling/project/Action_Category_CVG/training/gt/pose3d/S6_waiting_2.npy	/media/remote_home/weiling/project/Action_Category_CVG/training/gt/label/S6_waiting_2.csv
/media/remote_home/weiling/project/Action_Category_CVG/training/gt/pose3d/S6_walkdog_1.npy	/media/remote_home/weiling/project/Action_Category_CVG/training/gt/label/S6_walkdog_1.csv
/media/remote_home/weiling/project/Action_Category_CVG/training/gt/pose3d/S6_walkdog_2.npy	/media/remote_home/weiling/project/Action_Category_CVG/training/gt/label/S6_walkdog_2.csv
/media/remote_home/weiling/project/Action_Category_CVG/training/gt/pose3d/S6_walking_1.npy	/media/remote_home/weiling/project/Action_Category_CVG/training/gt/label/S6_walking_1.csv
/media/remote_home/weiling/project/Action_Category_CVG/training/gt/pose3d/S6_walking_2.npy	/media/remote_home/weiling/project/Action_Category_CVG/training/gt/label/S6_walking_2.csv
/media/remote_home/weiling/project/Action_Category_CVG/training/gt/pose3d/S6_walkingtogether_1.npy	/media/remote_home/weiling/project/Action_Category_CVG/training/gt/label/S6_walkingtogether_1.csv
/media/remote_home/weiling/project/Action_Category_CVG/training/gt/pose3d/S6_walkingtogether_2.npy	/media/remote_home/weiling/project/Action_Category_CVG/training/gt/label/S6_walkingtogether_2.csv
/media/remote_home/weiling/project/Action_Category_CVG/training/gt/pose3d/S7_directions_1.npy	/media/remote_home/weiling/project/Action_Category_CVG/training/gt/label/S7_directions_1.csv
/media/remote_home/weiling/project/Action_Category_CVG/training/gt/pose3d/S7_directions_2.npy	/media/remote_home/weiling/project/Action_Category_CVG/training/gt/label/S7_directions_2.csv
/media/remote_home/weiling/project/Action_Category_CVG/training/gt/pose3d/S7_discussion_1.npy	/media/remote_home/weiling/project/Action_Category_CVG/training/gt/label/S7_discussion_1.csv
/media/remote_home/weiling/project/Action_Category_CVG/training/gt/pose3d/S7_discussion_2.npy	/media/remote_home/weiling/project/Action_Category_CVG/training/gt/label/S7_discussion_2.csv
/media/remote_home/weiling/project/Action_Category_CVG/training/gt/pose3d/S7_eating_1.npy	/media/remote_home/weiling/project/Action_Category_CVG/training/gt/label/S7_eating_1.csv
/media/remote_home/weiling/project/Action_Category_CVG/training/gt/pose3d/S7_eating_2.npy	/media/remote_home/weiling/project/Action_Category_CVG/training/gt/label/S7_eating_2.csv
/media/remote_home/weiling/project/Action_Category_CVG/training/gt/pose3d/S7_greeting_1.npy	/media/remote_home/weiling/project/Action_Category_CVG/training/gt/label/S7_greeting_1.csv
/media/remote_home/weiling/project/Action_Category_CVG/training/gt/pose3d/S7_greeting_2.npy	/media/remote_home/weiling/project/Action_Category_CVG/training/gt/label/S7_greeting_2.csv
/media/remote_home/weiling/project/Action_Category_CVG/training/gt/pose3d/S7_phoning_1.npy	/media/remote_home/weiling/project/Action_Category_CVG/training/gt/label/S7_phoning_1.csv
/media/remote_home/weiling/project/Action_Category_CVG/training/gt/pose3d/S7_phoning_2.npy	/media/remote_home/weiling/project/Action_Category_CVG/training/gt/label/S7_phoning_2.csv
/media/remote_home/weiling/project/Action_Category_CVG/training/gt/pose3d/S7_photo_1.npy	/media/remote_home/weiling/project/Action_Category_CVG/training/gt/label/S7_photo_1.csv
/media/remote_home/weiling/project/Action_Category_CVG/training/gt/pose3d/S7_photo_2.npy	/media/remote_home/weiling/project/Action_Category_CVG/training/gt/label/S7_photo_2.csv
/media/remote_home/weiling/project/Action_Category_CVG/training/gt/pose3d/S7_posing_1.npy	/media/remote_home/weiling/project/Action_Category_CVG/training/gt/label/S7_posing_1.csv
/media/remote_home/weiling/project/Action_Category_CVG/training/gt/pose3d/S7_posing_2.npy	/media/remote_home/weiling/project/Action_Category_CVG/training/gt/label/S7_posing_2.csv
/media/remote_home/weiling/project/Action_Category_CVG/training/gt/pose3d/S7_purchases_1.npy	/media/remote_home/weiling/project/Action_Category_CVG/training/gt/label/S7_purchases_1.csv
/media/remote_home/weiling/project/Action_Category_CVG/training/gt/pose3d/S7_purchases_2.npy	/media/remote_home/weiling/project/Action_Category_CVG/training/gt/label/S7_purchases_2.csv
/media/remote_home/weiling/project/Action_Category_CVG/training/gt/pose3d/S7_sitting_1.npy	/media/remote_home/weiling/project/Action_Category_CVG/training/gt/label/S7_sitting_1.csv
/media/remote_home/weiling/project/Action_Category_CVG/training/gt/pose3d/S7_sitting_2.npy	/media/remote_home/weiling/project/Action_Category_CVG/training/gt/label/S7_sitting_2.csv
/media/remote_home/weiling/project/Action_Category_CVG/training/gt/pose3d/S7_sittingdown_1.npy	/media/remote_home/weiling/project/Action_Category_CVG/training/gt/label/S7_sittingdown_1.csv
/media/remote_home/weiling/project/Action_Category_CVG/training/gt/pose3d/S7_sittingdown_2.npy	/media/remote_home/weiling/project/Action_Category_CVG/training/gt/label/S7_sittingdown_2.csv
/media/remote_home/weiling/project/Action_Category_CVG/training/gt/pose3d/S7_smoking_1.npy	/media/remote_home/weiling/project/Action_Category_CVG/training/gt/label/S7_smoking_1.csv
/media/remote_home/weiling/project/Action_Category_CVG/training/gt/pose3d/S7_smoking_2.npy	/media/remote_home/weiling/project/Action_Category_CVG/training/gt/label/S7_smoking_2.csv
/media/remote_home/weiling/project/Action_Category_CVG/training/gt/pose3d/S7_waiting_1.npy	/media/remote_home/weiling/project/Action_Category_CVG/training/gt/label/S7_waiting_1.csv
/media/remote_home/weiling/project/Action_Category_CVG/training/gt/pose3d/S7_waiting_2.npy	/media/remote_home/weiling/project/Action_Category_CVG/training/gt/label/S7_waiting_2.csv
/media/remote_home/weiling/project/Action_Category_CVG/training/gt/pose3d/S7_walkdog_1.npy	/media/remote_home/weiling/project/Action_Category_CVG/training/gt/label/S7_walkdog_1.csv
/media/remote_home/weiling/project/Action_Category_CVG/training/gt/pose3d/S7_walkdog_2.npy	/media/remote_home/weiling/project/Action_Category_CVG/training/gt/label/S7_walkdog_2.csv
/media/remote_home/weiling/project/Action_Category_CVG/training/gt/pose3d/S7_walking_1.npy	/media/remote_home/weiling/project/Action_Category_CVG/training/gt/label/S7_walking_1.csv
/media/remote_home/weiling/project/Action_Category_CVG/training/gt/pose3d/S7_walking_2.npy	/media/remote_home/weiling/project/Action_Category_CVG/training/gt/label/S7_walking_2.csv
/media/remote_home/weiling/project/Action_Category_CVG/training/gt/pose3d/S7_walkingtogether_1.npy	/media/remote_home/weiling/project/Action_Category_CVG/training/gt/label/S7_walkingtogether_1.csv
/media/remote_home/weiling/project/Action_Category_CVG/training/gt/pose3d/S7_walkingtogether_2.npy	/media/remote_home/weiling/project/Action_Category_CVG/training/gt/label/S7_walkingtogether_2.csv
/media/remote_home/weiling/project/Action_Category_CVG/training/gt/pose3d/S8_directions_1.npy	/media/remote_home/weiling/project/Action_Category_CVG/training/gt/label/S8_directions_1.csv
/media/remote_home/weiling/project/Action_Category_CVG/training/gt/pose3d/S8_directions_2.npy	/media/remote_home/weiling/project/Action_Category_CVG/training/gt/label/S8_directions_2.csv
/media/remote_home/weiling/project/Action_Category_CVG/training/gt/pose3d/S8_discussion_1.npy	/media/remote_home/weiling/project/Action_Category_CVG/training/gt/label/S8_discussion_1.csv
/media/remote_home/weiling/project/Action_Category_CVG/training/gt/pose3d/S8_discussion_2.npy	/media/remote_home/weiling/project/Action_Category_CVG/training/gt/label/S8_discussion_2.csv
/media/remote_home/weiling/project/Action_Category_CVG/training/gt/pose3d/S8_eating_1.npy	/media/remote_home/weiling/project/Action_Category_CVG/training/gt/label/S8_eating_1.csv
/media/remote_home/weiling/project/Action_Category_CVG/training/gt/pose3d/S8_eating_2.npy	/media/remote_home/weiling/project/Action_Category_CVG/training/gt/label/S8_eating_2.csv
/media/remote_home/weiling/project/Action_Category_CVG/training/gt/pose3d/S8_greeting_1.npy	/media/remote_home/weiling/project/Action_Category_CVG/training/gt/label/S8_greeting_1.csv
/media/remote_home/weiling/project/Action_Category_CVG/training/gt/pose3d/S8_greeting_2.npy	/media/remote_home/weiling/project/Action_Category_CVG/training/gt/label/S8_greeting_2.csv
/media/remote_home/weiling/project/Action_Category_CVG/training/gt/pose3d/S8_phoning_1.npy	/media/remote_home/weiling/project/Action_Category_CVG/training/gt/label/S8_phoning_1.csv
/media/remote_home/weiling/project/Action_Category_CVG/training/gt/pose3d/S8_phoning_2.npy	/media/remote_home/weiling/project/Action_Category_CVG/training/gt/label/S8_phoning_2.csv
/media/remote_home/weiling/project/Action_Category_CVG/training/gt/pose3d/S8_photo_1.npy	/media/remote_home/weiling/project/Action_Category_CVG/training/gt/label/S8_photo_1.csv
/media/remote_home/weiling/project/Action_Category_CVG/training/gt/pose3d/S8_photo_2.npy	/media/remote_home/weiling/project/Action_Category_CVG/training/gt/label/S8_photo_2.csv
/media/remote_home/weiling/project/Action_Category_CVG/training/gt/pose3d/S8_posing_1.npy	/media/remote_home/weiling/project/Action_Category_CVG/training/gt/label/S8_posing_1.csv
/media/remote_home/weiling/project/Action_Category_CVG/training/gt/pose3d/S8_posing_2.npy	/media/remote_home/weiling/project/Action_Category_CVG/training/gt/label/S8_posing_2.csv
/media/remote_home/weiling/project/Action_Category_CVG/training/gt/pose3d/S8_purchases_1.npy	/media/remote_home/weiling/project/Action_Category_CVG/training/gt/label/S8_purchases_1.csv
/media/remote_home/weiling/project/Action_Category_CVG/training/gt/pose3d/S8_purchases_2.npy	/media/remote_home/weiling/project/Action_Category_CVG/training/gt/label/S8_purchases_2.csv
/media/remote_home/weiling/project/Action_Category_CVG/training/gt/pose3d/S8_sitting_1.npy	/media/remote_home/weiling/project/Action_Category_CVG/training/gt/label/S8_sitting_1.csv
/media/remote_home/weiling/project/Action_Category_CVG/training/gt/pose3d/S8_sitting_2.npy	/media/remote_home/weiling/project/Action_Category_CVG/training/gt/label/S8_sitting_2.csv
/media/remote_home/weiling/project/Action_Category_CVG/training/gt/pose3d/S8_sittingdown_1.npy	/media/remote_home/weiling/project/Action_Category_CVG/training/gt/label/S8_sittingdown_1.csv
/media/remote_home/weiling/project/Action_Category_CVG/training/gt/pose3d/S8_sittingdown_2.npy	/media/remote_home/weiling/project/Action_Category_CVG/training/gt/label/S8_sittingdown_2.csv
/media/remote_home/weiling/project/Action_Category_CVG/training/gt/pose3d/S8_smoking_1.npy	/media/remote_home/weiling/project/Action_Category_CVG/training/gt/label/S8_smoking_1.csv
/media/remote_home/weiling/project/Action_Category_CVG/training/gt/pose3d/S8_smoking_2.npy	/media/remote_home/weiling/project/Action_Category_CVG/training/gt/label/S8_smoking_2.csv
/media/remote_home/weiling/project/Action_Category_CVG/training/gt/pose3d/S8_waiting_1.npy	/media/remote_home/weiling/project/Action_Category_CVG/training/gt/label/S8_waiting_1.csv
/media/remote_home/weiling/project/Action_Category_CVG/training/gt/pose3d/S8_waiting_2.npy	/media/remote_home/weiling/project/Action_Category_CVG/training/gt/label/S8_waiting_2.csv
/media/remote_home/weiling/project/Action_Category_CVG/training/gt/pose3d/S8_walkdog_1.npy	/media/remote_home/weiling/project/Action_Category_CVG/training/gt/label/S8_walkdog_1.csv
/media/remote_home/weiling/project/Action_Category_CVG/training/gt/pose3d/S8_walkdog_2.npy	/media/remote_home/weiling/project/Action_Category_CVG/training/gt/label/S8_walkdog_2.csv
/media/remote_home/weiling/project/Action_Category_CVG/training/gt/pose3d/S8_walking_1.npy	/media/remote_home/weiling/project/Action_Category_CVG/training/gt/label/S8_walking_1.csv
/media/remote_home/weiling/project/Action_Category_CVG/training/gt/pose3d/S8_walking_2.npy	/media/remote_home/weiling/project/Action_Category_CVG/training/gt/label/S8_walking_2.csv
/media/remote_home/weiling/project/Action_Category_CVG/training/gt/pose3d/S8_walkingtogether_1.npy	/media/remote_home/weiling/project/Action_Category_CVG/training/gt/label/S8_walkingtogether_1.csv
/media/remote_home/weiling/project/Action_Category_CVG/training/gt/pose3d/S8_walkingtogether_2.npy	/media/remote_home/weiling/project/Action_Category_CVG/training/gt/label/S8_walkingtogether_2.csv
/media/remote_home/weiling/project/Action_Category_CVG/training/gt/pose3d/S9_directions_1.npy	/media/remote_home/weiling/project/Action_Category_CVG/training/gt/label/S9_directions_1.csv
/media/remote_home/weiling/project/Action_Category_CVG/training/gt/pose3d/S9_directions_2.npy	/media/remote_home/weiling/project/Action_Category_CVG/training/gt/label/S9_directions_2.csv
/media/remote_home/weiling/project/Action_Category_CVG/training/gt/pose3d/S9_discussion_1.npy	/media/remote_home/weiling/project/Action_Category_CVG/training/gt/label/S9_discussion_1.csv
/media/remote_home/weiling/project/Action_Category_CVG/training/gt/pose3d/S9_discussion_2.npy	/media/remote_home/weiling/project/Action_Category_CVG/training/gt/label/S9_discussion_2.csv
/media/remote_home/weiling/project/Action_Category_CVG/training/gt/pose3d/S9_eating_1.npy	/media/remote_home/weiling/project/Action_Category_CVG/training/gt/label/S9_eating_1.csv
/media/remote_home/weiling/project/Action_Category_CVG/training/gt/pose3d/S9_eating_2.npy	/media/remote_home/weiling/project/Action_Category_CVG/training/gt/label/S9_eating_2.csv
/media/remote_home/weiling/project/Action_Category_CVG/training/gt/pose3d/S9_greeting_1.npy	/media/remote_home/weiling/project/Action_Category_CVG/training/gt/label/S9_greeting_1.csv
/media/remote_home/weiling/project/Action_Category_CVG/training/gt/pose3d/S9_greeting_2.npy	/media/remote_home/weiling/project/Action_Category_CVG/training/gt/label/S9_greeting_2.csv
/media/remote_home/weiling/project/Action_Category_CVG/training/gt/pose3d/S9_phoning_1.npy	/media/remote_home/weiling/project/Action_Category_CVG/training/gt/label/S9_phoning_1.csv
/media/remote_home/weiling/project/Action_Category_CVG/training/gt/pose3d/S9_phoning_2.npy	/media/remote_home/weiling/project/Action_Category_CVG/training/gt/label/S9_phoning_2.csv
/media/remote_home/weiling/project/Action_Category_CVG/training/gt/pose3d/S9_photo_1.npy	/media/remote_home/weiling/project/Action_Category_CVG/training/gt/label/S9_photo_1.csv
/media/remote_home/weiling/project/Action_Category_CVG/training/gt/pose3d/S9_photo_2.npy	/media/remote_home/weiling/project/Action_Category_CVG/training/gt/label/S9_photo_2.csv
/media/remote_home/weiling/project/Action_Category_CVG/training/gt/pose3d/S9_posing_1.npy	/media/remote_home/weiling/project/Action_Category_CVG/training/gt/label/S9_posing_1.csv
/media/remote_home/weiling/project/Action_Category_CVG/training/gt/pose3d/S9_posing_2.npy	/media/remote_home/weiling/project/Action_Category_CVG/training/gt/label/S9_posing_2.csv
/media/remote_home/weiling/project/Action_Category_CVG/training/gt/pose3d/S9_purchases_1.npy	/media/remote_home/weiling/project/Action_Category_CVG/training/gt/label/S9_purchases_1.csv
/media/remote_home/weiling/project/Action_Category_CVG/training/gt/pose3d/S9_purchases_2.npy	/media/remote_home/weiling/project/Action_Category_CVG/training/gt/label/S9_purchases_2.csv
/media/remote_home/weiling/project/Action_Category_CVG/training/gt/pose3d/S9_sitting_1.npy	/media/remote_home/weiling/project/Action_Category_CVG/training/gt/label/S9_sitting_1.csv
/media/remote_home/weiling/project/Action_Category_CVG/training/gt/pose3d/S9_sitting_2.npy	/media/remote_home/weiling/project/Action_Category_CVG/training/gt/label/S9_sitting_2.csv
/media/remote_home/weiling/project/Action_Category_CVG/training/gt/pose3d/S9_sittingdown_1.npy	/media/remote_home/weiling/project/Action_Category_CVG/training/gt/label/S9_sittingdown_1.csv
/media/remote_home/weiling/project/Action_Category_CVG/training/gt/pose3d/S9_sittingdown_2.npy	/media/remote_home/weiling/project/Action_Category_CVG/training/gt/label/S9_sittingdown_2.csv
/media/remote_home/weiling/project/Action_Category_CVG/training/gt/pose3d/S9_smoking_1.npy	/media/remote_home/weiling/project/Action_Category_CVG/training/gt/label/S9_smoking_1.csv
/media/remote_home/weiling/project/Action_Category_CVG/training/gt/pose3d/S9_smoking_2.npy	/media/remote_home/weiling/project/Action_Category_CVG/training/gt/label/S9_smoking_2.csv
/media/remote_home/weiling/project/Action_Category_CVG/training/gt/pose3d/S9_waiting_1.npy	/media/remote_home/weiling/project/Action_Category_CVG/training/gt/label/S9_waiting_1.csv
/media/remote_home/weiling/project/Action_Category_CVG/training/gt/pose3d/S9_waiting_2.npy	/media/remote_home/weiling/project/Action_Category_CVG/training/gt/label/S9_waiting_2.csv
/media/remote_home/weiling/project/Action_Category_CVG/training/gt/pose3d/S9_walkdog_1.npy	/media/remote_home/weiling/project/Action_Category_CVG/training/gt/label/S9_walkdog_1.csv
/media/remote_home/weiling/project/Action_Category_CVG/training/gt/pose3d/S9_walkdog_2.npy	/media/remote_home/weiling/project/Action_Category_CVG/training/gt/label/S9_walkdog_2.csv
/media/remote_home/weiling/project/Action_Category_CVG/training/gt/pose3d/S9_walking_1.npy	/media/remote_home/weiling/project/Action_Category_CVG/training/gt/label/S9_walking_1.csv
/media/remote_home/weiling/project/Action_Category_CVG/training/gt/pose3d/S9_walking_2.npy	/media/remote_home/weiling/project/Action_Category_CVG/training/gt/label/S9_walking_2.csv
/media/remote_home/weiling/project/Action_Category_CVG/training/gt/pose3d/S9_walkingtogether_1.npy	/media/remote_home/weiling/project/Action_Category_CVG/training/gt/label/S9_walkingtogether_1.csv
/media/remote_home/weiling/project/Action_Category_CVG/training/gt/pose3d/S9_walkingtogether_2.npy	/media/remote_home/weiling/project/Action_Category_CVG/training/gt/label/S9_walkingtogether_2.csv
